comunidadesAutonomas,camionesYfurgonetas,autobuses,turismos,motocicletas,tractoresIndustriales,remolquesYsemirremolques,otrosVehiculos,total,anyo
Andalucia,91556,925,404682,41257,4615,0,17833,560868,2007
Aragon,18554,326,73853,5774,898,0,8448,107853,2007
Asturias,11147,193,55670,4498,704,0,3004,75216,2007
Illes Ballears,11269,70,64794,5984,171,0,1320,83608,2007
Canarias,29354,208,94567,9862,550,0,3385,137926,2007
Cantabria,5270,85,26007,2664,420,0,1277,35723,2007
Castilla La Mancha,32733,387,128813,8553,2179,0,10188,182853,2007
Castilla y Leon,25633,344,119963,8355,2077,0,10945,167317,2007
Catalunya,92162,662,419239,50738,3144,0,15731,581676,2007
Extremadura,13880,124,57983,3799,827,0,4334,80947,2007
Galicia,25805,457,139448,11393,1684,0,9653,188440,2007
Madrid,86601,1653,430209,25005,3756,0,8552,555776,2007
Murcia,17827,281,80131,7202,2047,0,4681,112169,2007
Navarra,9884,70,34124,2740,512,0,2626,49956,2007
La Rioja,5628,30,17308,1199,210,0,1459,25834,2007
Comunidad Valenciana,55755,408,275156,25629,4100,0,9915,370963,2007
Pais Vasco,20666,397,98039,9575,963,0,3441,133081,2007
Ceuta y Melilla,1495,3,7596,886,8,0,154,10142,2007
TOTAL GENERAL,555219,6623,2527582,225113,28865,0,116946,3460348,2007
Andalucia,83711,713,349082,40245,3787,0,10788,488326,2008
Aragon,16037,107,62394,5630,985,0,4721,89874,2008
Asturias,10454,165,49338,4545,690,0,1937,67129,2008
Illes Ballears,9865,168,57015,5776,102,0,733,73659,2008
Canarias,26156,214,83961,9680,344,0,2497,122852,2008
Cantabria,5081,81,22297,2590,351,0,872,31272,2008
Castilla La Mancha,23875,248,105768,8435,1702,0,4596,144624,2008
Castilla y Leon,30990,519,123932,8367,1756,0,3933,169497,2008
Catalunya,83925,664,368923,49751,2553,0,11803,517619,2008
Extremadura,50450,295,236146,24304,3360,0,7030,321585,2008
Galicia,12206,187,48786,3943,699,0,2031,67852,2008
Madrid,23894,372,120800,11478,1334,0,3950,161828,2008
Murcia,81128,1770,391580,24489,4255,0,8457,511679,2008
Navarra,15173,248,63483,6487,1640,0,3133,90164,2008
La Rioja,9234,55,30787,2663,435,0,1492,44666,2008
Comunidad Valenciana,19237,382,91007,9896,834,0,2754,124110,2008
Pais Vasco,4734,38,14368,1096,209,0,488,20933,2008
Ceuta y Melilla,1600,6,8036,926,6,0,120,10694,2008
TOTAL GENERAL,507750,6232,2227703,220301,25042,0,71335,3058363,2008
Andalucia,80376,705,322685,40344,3034,4085,5553,456782,2009
Aragon,15968,77,62172,5849,896,2449,1281,88692,2009
Asturias,10069,162,50036,4910,410,674,1090,67351,2009
Illes Ballears,9721,101,50617,5900,201,280,372,67192,2009
Canarias,24607,122,76673,9349,279,779,1472,113281,2009
Cantabria,4734,111,21371,2618,349,454,434,30071,2009
Castilla La Mancha,24885,278,108392,9092,1586,1879,2494,148606,2009
Castilla y Leon,31308,448,116745,8318,1875,1837,2005,162536,2009
Catalunya,80931,610,344079,49468,2366,4592,5816,487862,2009
Extremadura,46868,353,196509,23141,2715,3370,2345,275301,2009
Galicia,12787,137,48439,3998,583,881,1058,67883,2009
Madrid,23448,398,121431,11693,1202,1599,2330,162101,2009
Murcia,89707,927,395291,24478,5594,2127,6192,524316,2009
Navarra,15692,349,61886,6737,1468,1897,823,88852,2009
La Rioja,8351,197,29689,2814,423,522,702,42698,2009
Comunidad Valenciana,17981,309,90443,9796,801,1059,2355,122744,2009
Pais Vasco,4378,32,14303,1113,134,196,264,20420,2009
Ceuta y Melilla,1840,3,8380,970,8,16,116,11333,2009
TOTAL GENERAL,503651,5319,2119141,220588,23924,28696,36702,2938021,2009
Andalucia,85969,750,319141,40067,3664,4486,5786,459863,2010
Aragon,15377,72,54408,5711,953,2842,1345,80708,2010
Asturias,10370,190,47264,4766,486,695,1062,64833,2010
Illes Ballears,10464,193,52195,6107,278,308,367,69912,2010
Canarias,26500,196,79594,9592,327,892,1527,118628,2010
Cantabria,4584,38,21104,2657,547,519,449,29898,2010
Castilla La Mancha,25904,233,106004,9059,1795,2224,2510,147729,2010
Castilla y Leon,34081,460,111956,8171,2122,1955,2267,161012,2010
Catalunya,85468,732,350938,49711,2961,4846,5592,500248,2010
Extremadura,48547,385,197441,23457,3516,3418,2232,278996,2010
Galicia,13509,143,46871,4040,632,771,1242,67208,2010
Madrid,25106,363,120457,11756,1578,1956,2448,163664,2010
Murcia,104298,1408,417787,24557,5948,2224,4673,560895,2010
Navarra,17270,236,63149,6741,1591,1860,929,91776,2010
La Rioja,9259,60,31436,3062,372,550,763,45502,2010
Comunidad Valenciana,18413,331,87471,10058,956,1138,1914,120281,2010
Pais Vasco,4583,9,13929,1212,105,202,499,20539,2010
Ceuta y Melilla,1923,0,8069,1093,5,15,131,11236,2010
TOTAL GENERAL,541625,5799,2129214,221817,27836,30901,35736,2992928,2010
Andalucia,82455,602,309642,42492,4071,4895,6057,450214,2011
Aragon,14088,51,50452,5946,1061,3337,1313,76248,2011
Asturias,10006,137,46386,5296,506,736,1127,64194,2011
Illes Ballears,10637,143,52426,6722,226,387,395,70936,2011
Canarias,27825,212,82052,9972,370,843,1557,122831,2011
Cantabria,4629,69,20793,2662,412,510,432,29507,2011
Castilla La Mancha,24226,304,100814,9767,1721,2187,2761,141780,2011
Castilla y Leon,32343,532,110287,8522,1996,2098,2232,158010,2011
Catalunya,90665,750,370062,50336,3080,5581,5731,526205,2011
Extremadura,47434,372,197816,24077,3836,3738,2431,279704,2011
Galicia,12595,135,42239,4176,625,794,1227,61791,2011
Madrid,24285,310,111402,12290,1447,1847,2760,154341,2011
Murcia,97333,1255,386579,27168,6294,2521,4528,525678,2011
Navarra,16264,263,60601,6694,1588,1828,928,88166,2011
La Rioja,8649,63,29451,3073,331,569,753,42889,2011
Comunidad Valenciana,17953,341,82347,11035,1002,1133,1985,115796,2011
Pais Vasco,4423,12,14027,1267,133,210,349,20421,2011
Ceuta y Melilla,2063,1,8658,1073,9,19,100,11923,2011
TOTAL GENERAL,527873,5552,2076034,232568,28708,33233,36666,2940634,2011
Andalucia,81363,449,304199,41274,3834,5109,5886,442114,2012
Aragon,13996,30,50100,5846,962,3070,1802,75806,2012
Asturias,9624,129,43733,4729,598,923,1068,60804,2012
Illes Ballears,11332,246,54483,7443,318,408,478,74708,2012
Canarias,25791,311,76695,9567,307,779,1503,114953,2012
Cantabria,4674,59,20159,2416,286,426,425,28445,2012
Castilla La Mancha,23654,196,97111,8940,1639,2279,2773,136592,2012
Castilla y Leon,35509,486,124625,7957,1964,2270,2365,175176,2012
Catalunya,85226,567,356742,50593,3025,5164,6057,507374,2012
Extremadura,47415,230,198211,23962,3873,3824,2483,279998,2012
Galicia,12076,110,40294,3803,601,911,1164,58959,2012
Madrid,24399,247,110985,11152,1628,1980,2982,153373,2012
Murcia,85100,1070,377012,25990,8213,2484,4692,504561,2012
Navarra,16488,226,61656,6704,1751,2071,888,89784,2012
La Rioja,8669,55,30107,2679,455,636,740,43341,2012
Comunidad Valenciana,17801,353,80859,10023,958,1101,1781,112876,2012
Pais Vasco,4385,14,13408,1167,117,187,372,19650,2012
Ceuta y Melilla,2405,11,9468,1193,18,17,96,13208,2012
TOTAL GENERAL,509907,4789,2049847,225438,30547,33639,37555,2891722,2012
Andalucia,83733,698,314109,46227,4258,5555,6625,461205,2013
Aragon,14939,380,51691,6223,1091,3399,1488,79211,2013
Asturias,10274,191,45889,5170,602,839,1082,64047,2013
Illes Ballears,12061,222,56413,8414,264,354,477,78205,2013
Canarias,25671,176,78616,10602,336,874,1537,117812,2013
Cantabria,5007,71,21884,2720,374,446,570,31072,2013
Castilla La Mancha,25491,229,100462,9804,1635,2496,2969,143086,2013
Castilla y Leon,39751,559,149339,9152,2273,2287,2832,206193,2013
Catalunya,82691,539,359403,57293,3305,5408,6349,514988,2013
Extremadura,48062,366,202279,26676,4284,4655,2738,289060,2013
Galicia,12957,118,40973,4292,575,949,1395,61259,2013
Madrid,25714,345,116647,12071,1719,2285,2937,161718,2013
Murcia,76129,1267,359681,28657,7040,2494,7991,483259,2013
Navarra,17911,266,65856,7809,1947,2205,956,96950,2013
La Rioja,9475,75,33286,3331,472,703,866,48208,2013
Comunidad Valenciana,18697,403,84502,10835,890,1247,1977,118551,2013
Pais Vasco,4465,20,13008,1334,149,236,378,19590,2013
Ceuta y Melilla,2638,0,9269,1258,2,24,103,13294,2013
TOTAL GENERAL,515666,5925,2103307,251868,31216,36456,43270,2987708,2013
Andalucia,82039,574,327739,49778,4420,5582,6740,476872,2014
Aragon,14869,31,55404,6866,1092,3245,1494,83001,2014
Asturias,10622,156,49037,5722,740,812,1083,68172,2014
Illes Ballears,9765,261,47186,8384,208,363,385,66552,2014
Canarias,26741,230,87464,11345,314,825,1663,128582,2014
Cantabria,4941,39,23898,3010,404,436,466,33194,2014
Castilla La Mancha,25765,195,106180,10813,1879,2509,3068,150409,2014
Castilla y Leon,41891,521,164238,10192,2435,2434,2873,224584,2014
Catalunya,83134,544,384731,63549,3056,5691,5939,546644,2014
Extremadura,47819,492,210606,29730,4111,4470,2618,299846,2014
Galicia,12847,116,42645,4635,584,1003,1334,63164,2014
Madrid,26306,347,123331,13215,1897,2485,3327,170908,2014
Murcia,70116,1334,354612,31808,7120,2404,3722,471116,2014
Navarra,17358,203,69784,8740,1868,2474,1063,101490,2014
La Rioja,9487,60,34342,3772,403,715,884,49663,2014
Comunidad Valenciana,19034,551,90445,12429,663,1229,2072,126423,2014
Pais Vasco,4291,10,13956,1500,180,234,375,20546,2014
Ceuta y Melilla,3004,1,9769,1524,7,20,101,14426,2014
TOTAL GENERAL,510029,5665,2195367,277012,31381,36931,39207,3095592,2014
Andalucia,82322,778,333355,53595,4866,6418,6815,488149,2015
Aragon,14403,62,56088,7223,1331,3621,1347,84075,2015
Asturias,10198,217,49486,6019,676,808,1094,68498,2015
Illes Ballears,10997,247,55391,9621,301,370,392,77319,2015
Canarias,26870,237,94936,12416,357,915,1951,137682,2015
Cantabria,4734,67,23277,3270,406,430,510,32694,2015
Castilla La Mancha,24970,213,101757,11323,1825,2490,2617,145195,2015
Castilla y Leon,41904,432,173444,10366,2386,2289,2113,232934,2015
Catalunya,84400,722,396878,68539,3001,5639,5589,564768,2015
Extremadura,45694,533,212632,31482,4430,4781,2484,302036,2015
Galicia,12587,173,42638,4855,622,1031,1360,63266,2015
Madrid,25628,331,120183,14468,1828,2386,2787,167611,2015
Murcia,80307,1335,400584,34430,8163,2416,4050,531285,2015
Navarra,17313,303,70591,9398,2021,2651,970,103247,2015
La Rioja,8793,76,32053,3801,431,674,804,46632,2015
Comunidad Valenciana,17908,524,87561,12947,785,1368,2087,123180,2015
Pais Vasco,3988,16,13173,1567,149,201,269,19363,2015
Ceuta y Melilla,3301,1,10440,1581,5,16,109,15453,2015
TOTAL GENERAL,516317,6267,2274467,296901,33583,38504,37348,3203387,2015
Andalucia,86632,804,370718,57504,5273,6308,6790,534029,2016
Aragon,15007,45,59268,7777,1275,3584,1361,88317,2016
Asturias,10499,239,53541,6002,694,854,1110,72939,2016
Illes Ballears,12452,220,61911,10664,228,322,746,86543,2016
Canarias,29507,251,103358,13814,418,895,2017,150260,2016
Cantabria,4858,67,25051,3330,347,488,471,34612,2016
Castilla La Mancha,25917,220,110337,12090,1866,2590,2809,155829,2016
Castilla y Leon,40816,575,205670,11516,2656,2517,2232,265982,2016
Catalunya,87167,505,424845,71687,3430,5703,5654,598991,2016
Extremadura,46611,639,231995,34190,3793,5257,2462,324947,2016
Galicia,12372,163,46389,5260,667,1038,1365,67254,2016
Madrid,26812,321,132020,15129,2036,2579,2861,181758,2016
Murcia,83824,1286,443592,34661,10435,2631,3019,579448,2016
Navarra,17406,280,77483,9967,2142,2464,939,110681,2016
La Rioja,8939,60,35254,3956,507,639,746,50101,2016
Comunidad Valenciana,17578,352,92865,13233,651,1222,2135,128036,2016
Pais Vasco,3960,32,14116,1644,191,244,360,20547,2016
Ceuta y Melilla,3298,1,10808,1724,9,19,106,15965,2016
TOTAL GENERAL,533655,6060,2499221,314148,36618,39354,37183,3466239,2016
Andalucia,88925,575,421969,60902,4679,6143,6697,589890,2017
Aragon,14705,55,65706,7790,1332,4546,1329,95463,2017
Asturias,10305,141,58399,6232,623,736,1122,77558,2017
Illes Ballears,12868,176,68454,11372,208,391,509,93978,2017
Canarias,31856,274,118838,14492,372,1100,2442,169374,2017
Cantabria,4886,41,27351,3409,320,438,472,36917,2017
Castilla La Mancha,25597,188,120681,12584,1691,2428,2701,165870,2017
Castilla y Leon,38774,585,249348,12169,2278,2509,2223,307886,2017
Catalunya,86295,454,460264,71451,3066,5459,5416,632405,2017
Extremadura,47848,633,255347,35063,3099,4861,2511,349362,2017
Galicia,12745,131,52293,5183,700,1018,1234,73304,2017
Madrid,26467,405,143916,15872,1691,2401,2957,193709,2017
Murcia,80930,1446,489017,40276,11105,2266,3089,628129,2017
Navarra,17547,298,87591,10297,1998,2119,1007,120857,2017
La Rioja,9529,67,40025,3979,462,843,806,55711,2017
Comunidad Valenciana,18072,357,104408,13112,625,1236,2024,139834,2017
Pais Vasco,3897,14,15361,1637,162,224,326,21621,2017
Ceuta y Melilla,3583,4,10543,1859,4,19,129,16141,2017
TOTAL GENERAL,534829,5844,2789511,327679,34415,38737,36994,3768009,2017
Andalucia,92352,572,450929,60223,4530,5702,6729,621037,2018
Aragon,14873,37,66181,7736,1196,3848,1333,95204,2018
Asturias,10034,124,59750,5877,601,694,966,78046,2018
Illes Ballears,12844,149,69259,11299,270,369,522,94712,2018
Canarias,32588,213,128464,14619,432,1117,2195,179628,2018
Cantabria,4881,29,28550,3415,383,421,416,38095,2018
Castilla La Mancha,26431,135,125394,12296,1933,2593,2814,171596,2018
Castilla y Leon,38858,532,266894,12152,2908,2405,2354,326103,2018
Catalunya,88998,706,497879,73194,3185,5643,5857,675462,2018
Extremadura,47105,571,267353,35257,3068,6330,2611,362295,2018
Galicia,13520,103,55707,5409,651,1066,1230,77686,2018
Madrid,26552,269,152442,15806,1855,2426,2947,202297,2018
Murcia,88978,1228,540935,37357,12959,2575,3366,687398,2018
Navarra,17367,205,91051,10306,2393,2552,1117,124991,2018
La Rioja,9643,75,40234,4277,426,599,771,56025,2018
Comunidad Valenciana,18499,365,107370,13213,606,1115,2045,143213,2018
Pais Vasco,3867,11,15641,1650,129,257,370,21925,2018
Ceuta y Melilla,3637,3,9650,1823,12,20,147,15292,2018
TOTAL GENERAL,551027,5327,2973683,325909,37537,39732,37790,3971005,2018
Andalucia,90636,479,462024,63948,4477,5550,7132,634246,2019
Aragon,14288,35,64746,8135,1014,4093,1383,93694,2019
Asturias,9551,145,58488,6452,579,646,1078,76939,2019
Illes Ballears,12502,246,68649,11690,213,313,590,94203,2019
Canarias,33560,221,128388,15761,335,946,2357,181568,2019
Cantabria,4969,33,28858,3639,306,455,471,38731,2019
Castilla La Mancha,26628,323,128330,13269,1894,2611,2807,175862,2019
Castilla y Leon,47041,616,297577,13484,5131,2468,2438,368755,2019
Catalunya,90367,431,495627,78192,3000,5753,7013,680383,2019
Extremadura,46701,553,271169,36781,3459,5176,2797,366636,2019
Galicia,13127,176,56790,5693,586,1031,1250,78653,2019
Madrid,26197,272,152438,16571,2403,2376,3290,203547,2019
Murcia,84402,967,537440,40591,9134,2044,3194,677772,2019
Navarra,16532,184,93072,10638,2131,2296,1071,125924,2019
La Rioja,9485,82,38935,4257,487,628,818,54692,2019
Comunidad Valenciana,18836,445,106900,13948,696,1250,2220,144295,2019
Pais Vasco,3897,13,15573,1735,139,206,518,22081,2019
Ceuta y Melilla,2524,5,9146,2034,12,14,96,13831,2019
TOTAL GENERAL,551243,5226,3014150,346818,35996,37856,40523,4031812,2019
